!!!!!!!!!!!
!#####!!!!!
!#@  #!!!!!
!# $$#!###!
!# $ #!#.#!
!### ###.#!
!!##    .#!
!!#   #  #!
!!#   ####!
!!#####!!!!
!!!!!!!!!!!
