!!!!!!!!!!
!!!###!!!!
!!!#.#!!!!
!!!# ####!
!###$ $.#!
!#. $@###!
!####$#!!!
!!!!#.#!!!
!!!!###!!!
!!!!!!!!!!